14
XXXXXXXXXXXXXXX
X.............X
X.XXX...XXXXX.X
X.X.X...X.X.X.X
X.XXX.XXXXXXX.X
X.X.X.X.X.....X
X.XXX.XXX.XXXXX
X.........X.X.X
X.XXXXXXX.XXXXX
X.X.X.X.X.....X
X.XXXXXXX.XXX.X
X.X.X.....X.X.X
X.XXX.....XXX.X
X.............X
XXXXXXXXXXXXXXX
