20
XXXXXXXXXXXXXXXXXXXXX
X.......X.X.X.X.....X
X.XXX...XXXXXXX.XXX.X
X.X.X...........X.X.X
X.XXX...XXXXXXX.XXX.X
X.X.X...X.X.X.X.X.X.X
X.XXX...XXXXXXX.XXX.X
X.X.X.......X.X.....X
X.XXX.XXXXX.XXX.X.XXX
X.....X.X.X.X.X...X.X
XXXXX.XXXXX.XXX.XXXXX
X.X.X...........X.X.X
XXXXX.XXX.XXXXX.XXXXX
X.....X.X.X.X.X.....X
X.XXXXXXX.XXXXX.XXX.X
X.X.X.X.X.X.X...X.X.X
X.XXXXXXX.XXX.XXXXX.X
X.X.X.X.......X.X.X.X
X.XXXXX.......XXXXX.X
X...................X
XXXXXXXXXXXXXXXXXXXXX
