20
XXXXXXXXXXXXXXXXXXXXX
X.......X.X.X.X.....X
X.XXX...XXXXXXX.XXX.X
X.X.X...........X.X.X
X.XXXXX.X.X.X.XXXXX.X
X.X.X.X.......X.X.X.X
X.XXXXX.X.X.X.XXXXX.X
X.X.X...............X
X.XXX.X.X.X.X.X.X.XXX
X.................X.X
XXXXX.X.X.X.X.X.XXXXX
X.X.X...........X.X.X
XXXXX.X.X.X.X.X.XXXXX
X...................X
X.XXX.X.X.X.X.XXXXX.X
X.X.X.........X.X.X.X
X.XXXXXXX.X.XXXXXXX.X
X.X.X.X.X...X.X.X.X.X
X.XXXXXXX...XXXXXXX.X
X...................X
XXXXXXXXXXXXXXXXXXXXX
