20
XXXXXXXXXXXXXXXXXXXXX
X.....X.............X
X.XXX.X.XXXXXXX.XXX.X
X.X.X.....X.X.X.X.X.X
X.XXX.XXX.XXXXX.XXX.X
X.X.X...X.....X.....X
X.XXX...XXXXX.XXX.X.X
X...X.......X.....X.X
X.X.X.XXXXX.XXX.XXX.X
X.X...X.X.X.X.X.X.X.X
X.XXX.XXXXX.XXX.XXX.X
X...X...........X...X
XXX.X.XXX.XXX.XXX.XXX
X.....X.X.X.X.X...X.X
X.XXXXXXX.XXX.X.X.X.X
X.X.X.....X.X...X...X
X.XXX.XXX.XXX.XXXXX.X
X.....X...X...X.X.X.X
X.XXXXX...X...XXXXX.X
X...................X
XXXXXXXXXXXXXXXXXXXXX
